S....#####
.###......
.####.###.
###.#..##.
######.##.
#......##.
####.####.
#......##.
#####.##.#
####D.....
