S....#####
.###......
.#####....
###.#..##.
#####.###.
#......##.
#.....###.
####...###
####......
####D.....
