S....#####
.###......
.##...###.
###.#..##.
######.##.
#......##.
#.#######.
#......###
########..
####D.....
